29 117
111111111111111111111111111111111111111111111111111111111111111111111111111111111111111111111111111111111111111111111
100000000000000000000000000000000000000000000000000000000000000000000000000000000000000000000000000000000000000000001
100000000000000000000000000000000000000000111111111111000000000000000000000000000000000000000000000000000000000000001
100000000000000000000000000000000000000000100000000011000000000000000000000000000000000000000000000000000000000000001
100000000000000000000000000000000000000000000111000011000000000000000000000000000000000000000000000000000000000000001
100000000000000000000000000000000000000000000001000011000000000000000000000000000000000000000000000000000000000000001
100000000000000000000000000000000000000000111101000011000000000000000000000000000000000000000000000000000000000000001
100000000000000000000000000000000000000000000000000000000000000000111111111111000000000000000000000000000000000000001
100000000000000000000000000000000000000000000000000000000000000000000000000000000000000000000000000000000000000000001
100000000000000000000000000000000000000000000000000000000000000000000000000000000000000000000000000000000000000000001
100000000000111111111000000000000000000000000000000000000000000000001000000000000000000000000000000000000000000000001
100000000000000000000000000000000000000000000000000000000000000000111000000000000000000000000000000000000000000000001
100000000000000000000000000000000000000000000000000000000000000001000000000000000000000000000000000000000000000000001
100000000000000000000000000000000000000000000000000000000000000000110000000000000000000000000000000000000000000000001
100000000000000000000000000000000000000000000000000000001000000000010000000000000000000000000000000000000000000000001
100000000000000000000000000000000000000000000000000000001000000000000000000000000000000000100000000000000000000000001
100000000000000000000000000000000000000000000000000000001000000000000000000000000000000000100000000000000000000000001
100000000000000000000001000000000000000000000000000000001000000000000000000000000000000000100000000000000000000000001
100000000000000000000001000000000000000000000000000000001000000000000000000000000000000000100000000000000000000000001
100000000000000000000001000000000000000000000000000000001111111111000000000000000000000000100000000000000000000000001
100000000000000000000001000000000000000000000000000000000000000000000000000000000000000000100000000000000000000000001
100000000000000000000001000000011111111111111111111000000000000000000000000000000000000000100000000000000000000000001
100000000000000000000001000000000000000000000000000000000000000000000000000000000000000000100000000000000000000000001
100000000000000000000001000000000000000000000000000000000000000000000000000000000000000000000000000000000000000000001
100000000000000000000001000000000000000000000000000000000000000000000000000000000000000000000000000000000000000000001
100000000000000000000001000000000000000000000000000000000000000000000000000000000000000000000000000000000000000000001
100000000000000000000001000000000000000000000000000000000000000000000000000000000000000000000000000000000000000000001
100000000000000000000000000000000000000000000000000000000000000000000000000000000000000000000000000000000000000000001
111111111111111111111111111111111111111111111111111111111111111111111111111111111111111111111111111111111111111111111
3 5
5
3 3
20 20
26 100
15 85
4 34
